XXXXXXXXXXXXXXXXXX
XH0H1H2H3H4 X  H0X
X           X    X
X   y       X    X
X                X
X                X
X1   B3         3X
X1              3X
X1    w         3X
X1              3X
X2              4X
X2     B2       4X
X2              4X
X2      g       4X
XXXXXXXXXXX      X
X B0B0           X
X SB0            X
XXXXXXXXXXXXXXXXXX
